antiobesity preparations	are	medications
antiobesity preparations	treat	obesity
antiobesity preparations	work by	appetite suppression
antiobesity preparations	may cause	gastrointestinal side effects
obesity	increases risk of	diabetes
obesity	increases risk of	hypertension
obesity	increases risk of	heart disease
appetite suppression	reduces	food intake
gastrointestinal side effects	include	nausea
gastrointestinal side effects	include	diarrhea
antiobesity preparations	may interact with	antidepressants
antiobesity preparations	contraindicated in	pregnancy
pregnancy	requires	medical supervision
antiobesity preparations	prescribed by	physicians
physicians	monitor	weight loss progress
weight loss progress	measured by	BMI reduction
BMI reduction	improves	metabolic health
metabolic health	affects	insulin sensitivity
insulin sensitivity	influences	blood sugar levels
blood sugar levels	impact	diabetes management
antiobesity preparations	may contain	orlistat
orlistat	inhibits	fat absorption
fat absorption	leads to	calorie reduction
calorie reduction	results in	weight loss
orlistat	may cause	oily stools
oily stools	indicate	fat malabsorption
fat malabsorption	requires	vitamin supplementation
vitamin supplementation	prevents	deficiencies
deficiencies	cause	health complications
health complications	increase	medical costs
antiobesity preparations	may include	phentermine
phentermine	stimulates	central nervous system
central nervous system	regulates	appetite
phentermine	increases	heart rate
heart rate	affects	cardiovascular health
cardiovascular health	impacts	mortality risk
mortality risk	reduced by	weight management
weight management	involves	lifestyle changes
lifestyle changes	include	exercise
exercise	enhances	metabolic rate
metabolic rate	determines	calorie expenditure
calorie expenditure	contributes to	weight control
antiobesity preparations	sometimes combined with	topiramate
topiramate	originally developed for	epilepsy
epilepsy	treated with	anticonvulsants
topiramate	has	weight loss side effect
weight loss side effect	beneficial for	obesity treatment
topiramate	may cause	cognitive side effects
cognitive side effects	include	memory problems
memory problems	affect	daily functioning
antiobesity preparations	require	prescription
prescription	ensures	proper usage
proper usage	minimizes	adverse effects
adverse effects	reported to	healthcare providers
healthcare providers	adjust	dosages
dosages	tailored to	individual needs
individual needs	depend on	medical history
medical history	includes	chronic conditions
chronic conditions	complicate	obesity treatment
obesity treatment	improves	quality of life
quality of life	measured by	patient surveys
patient surveys	assess	treatment satisfaction
treatment satisfaction	influences	adherence
adherence	determines	treatment success
treatment success	reduces	hospital readmissions
hospital readmissions	increase	healthcare costs
healthcare costs	burden	insurance systems
insurance systems	cover	antiobesity medications
antiobesity medications	expensive for	uninsured patients
uninsured patients	face	financial barriers
financial barriers	limit	treatment access
treatment access	affects	health outcomes
health outcomes	worse in	low-income populations
low-income populations	have	higher obesity rates
higher obesity rates	correlate with	food deserts
food deserts	lack	healthy options
healthy options	promote	weight maintenance
weight maintenance	prevents	obesity recurrence
obesity recurrence	common after	medication discontinuation
medication discontinuation	occurs due to	side effects
side effects	managed by	dose adjustments
dose adjustments	prescribed by	endocrinologists
endocrinologists	specialize in	metabolic disorders
metabolic disorders	linked to	obesity
obesity	associated with	sleep apnea
sleep apnea	treated with	CPAP therapy
CPAP therapy	improves	sleep quality
sleep quality	affects	daytime energy
daytime energy	influences	physical activity
physical activity	aids	weight loss
weight loss	decreases	joint pain
joint pain	common in	obese individuals
obese individuals	benefit from	physiotherapy
physiotherapy	enhances	mobility
mobility	important for	independent living
independent living	requires	functional ability
functional ability	declines with	severe obesity
severe obesity	treated with	bariatric surgery
bariatric surgery	more effective than	medications alone
medications alone	insufficient for	long-term weight control
