antivaricose therapy drugs	treat	varicose veins
antivaricose therapy drugs	contain	flavonoids
flavonoids	improve	venous tone
venous tone	affects	blood circulation
blood circulation	prevents	venous stasis
venous stasis	causes	edema
edema	symptom of	chronic venous insufficiency
chronic venous insufficiency	leads to	venous ulcers
venous ulcers	treated with	wound care
wound care	involves	dressings
dressings	contain	antimicrobial agents
antimicrobial agents	prevent	infections
infections	complication of	open wounds
open wounds	result from	trauma
trauma	includes	surgical procedures
surgical procedures	option for	severe varicose veins
severe varicose veins	lead to	pain
pain	managed with	analgesics
analgesics	include	NSAIDs
NSAIDs	reduce	inflammation
inflammation	symptom of	phlebitis
phlebitis	involves	vein inflammation
vein inflammation	caused by	blood clots
blood clots	risk factor for	deep vein thrombosis
deep vein thrombosis	treated with	anticoagulants
anticoagulants	prevent	thrombosis
thrombosis	leads to	pulmonary embolism
pulmonary embolism	life-threatening condition	requires hospitalization
hospitalization	involves	monitoring
monitoring	includes	vital signs
vital signs	indicate	patient stability
patient stability	assessed by	physicians
physicians	prescribe	medications
medications	include	antivaricose therapy drugs
antivaricose therapy drugs	improve	microcirculation
microcirculation	affects	tissue oxygenation
tissue oxygenation	essential for	wound healing
wound healing	delayed by	diabetes
diabetes	risk factor for	poor circulation
poor circulation	exacerbates	varicose veins
varicose veins	associated with	obesity
obesity	managed with	lifestyle changes
lifestyle changes	include	exercise
exercise	improves	venous return
venous return	supported by	compression stockings
compression stockings	adjunct to	drug therapy
drug therapy	includes	diosmin
diosmin	derived from	citrus fruits
citrus fruits	source of	vitamin C
vitamin C	supports	collagen synthesis
collagen synthesis	strengthens	vein walls
vein walls	weakened in	varicose veins
varicose veins	hereditary in	some patients
some patients	require	sclerotherapy
sclerotherapy	involves	injections
injections	cause	vein collapse
vein collapse	leads to	fibrosis
fibrosis	results in	vein disappearance
vein disappearance	improves	cosmetic appearance
cosmetic appearance	concern for	patients
patients	seek	medical advice
medical advice	given by	specialists
specialists	include	phlebologists
phlebologists	diagnose	venous disorders
venous disorders	include	spider veins
spider veins	treated with	laser therapy
laser therapy	uses	light energy
light energy	targets	hemoglobin
hemoglobin	found in	red blood cells
red blood cells	transport	oxygen
oxygen	necessary for	cellular metabolism
cellular metabolism	produces	energy
energy	required for	muscle contraction
muscle contraction	aids	venous return
venous return	impaired in	sedentary lifestyle
sedentary lifestyle	contributes to	venous hypertension
venous hypertension	causes	valve dysfunction
valve dysfunction	leads to	reflux
reflux	results in	venous dilation
venous dilation	visible as	varicose veins
varicose veins	may cause	itching
itching	relieved by	topical creams
topical creams	contain	anti-inflammatory agents
anti-inflammatory agents	reduce	skin irritation
skin irritation	caused by	stasis dermatitis
stasis dermatitis	complication of	chronic venous disease
chronic venous disease	progresses to	lipodermatosclerosis
lipodermatosclerosis	involves	skin hardening
skin hardening	restricts	mobility
mobility	improved by	physical therapy
physical therapy	includes	leg elevation
leg elevation	reduces	swelling
swelling	alleviated by	diuretics
diuretics	prescribed for	fluid retention
fluid retention	symptom of	heart failure
heart failure	complicates	venous return
venous return	enhanced by	muscle pumps
muscle pumps	activated by	walking
walking	recommended for	vein health
vein health	maintained by	antivaricose therapy drugs
